7
7
1 1 1 1 1 1 1
1 9 0 0 3 0 1
1 0 0 0 8 0 1
1 0 4 0 0 0 1
1 0 0 0 0 0 1
1 0 6 0 7 5 1
1 1 1 1 1 1 1
