7
7
1 1 1 1 1 1 1
1 9 0 0 0 0 1
1 0 0 4 8 0 1
1 0 0 0 0 0 1
1 0 0 4 0 4 1
1 4 6 0 0 5 1
1 1 1 1 1 1 1
